o------------------o
l                  l
l                o l
l      o   o     l l
l     ooo ooo    lkl
l      ooooo     l l
l       ooo      l l
l        d       l l
l                l l
l                o l
l                  l
o----------------o-o