o--o  o------o      
ld l oo      o-o    
l  o-o  o-o s  o--o 
oo    G l l       oo
 l     tl o------o l
oo------o        l l
lttt      L o----o l
ltt  o---o lk      l
oo       l l G   o-o
 o--o  T o-o   o-o  
    o-o      o-o    
      o------o      
