      o-o---------o 
   o--otl         oo
   l    l          l
o--o    l   t      l
l t o---o-----o    o
lt  g       k    L d
l t o---o-----o    o
o--o    l   t      l
   l    l          l
   o--otl         oo
      o-o---------o