  o-----------o          
  l s         l     
  l           l     
  o--o  o-ott l     
     l   gl  oo----o
  o--o   ol        l
  l     o-o       kl
  l     l ot       l
  od    l oo-o  o--o
   o-o--o  l    l   
           l    l
           o----o