o--------------o---o
l L            l   l
l oo ooto---oo l o l
l lt o o   t   l o l
l o o oo o-o   l   l
l   lt lLo l o l o l
l o l oo   o l oo  l
lol l  lt s  l   o l
l l l ooGTgo loo   l
l o l o-o oo l o   l
lk  l        l   o l
o---o--------o---odo